###############
#@..........T.#
#.............#
#...........T.#
###############
