#########################
@:::::::::::::::::::::::#
#######################:#
000000000000000000000#h::#
######################:::#
#:::::::::4:::::::::##:::#
#:::::::::4:::::::::X:::::#
#:::::::::4:::::::::X:::::#
#####################:::::#
#:::::::::::::::::::::::::#
#:::::E::::::E::::::::::::#
#::::::::E::::::::::::::::#
#:::E:::::::::::::::::::::#
#%:::::::::::::::::::::h::#
###########################
