###################
#@.....#....T..::::#####%#
#......#.E....#::::#.....#
#...........T.#::::#.....#
#######...#####::::#...E.#
000000#...::::::::::.....#
#######...######:::#.....#
#.h............#####...E.#
#....E...................#
#..............###########
################
