############################
#@.....................:::::#
#......................:::::#
#.......E.............##::::#
#.................E...##::::#
#.....................##:h::#
#######################:::::#
#:::::::::::::::::::::::::::#
#,,E,,,,,,,,,,,,,,E,,,,,,,,,#
#.........................EE#
###...#######################
##::::##################
#:::::::E:::::#
#############%#
0000000000000#
