###########################################
#,,,,,,,,,,,,,,,,,,,,,,,,,,,E,,,,,,,,,,,,,#
#,,@,,,,,,,,,,,,,,,,,,,,,,,,,,,,,,,,,,,,,,#
#,,,,,,,,,,,,,,,,,,,,,,,,,,,,,,,,,,,,,,,,,#
################.......................####
#::::::::::::::...........................#
#::::::::::E::::..........................#
#::::::E::::::::...........................#
#:::::::::::::::...........................#
############################################
