@............................22222
#.................................
#.................................
#.................................
############......................
..................................
T.................................
..................................
T.................................
::::::::::::::::::::::::::::::::::
::::::::::::::::::::::::::::::::::
EEEEE



