###############0000
#@.....#....T.#0000#######
#......#......#0000#.....#
#...........T.#0000#.....#
#######...#####0000#...E.#
000000#...#00000000#.....#
#######...######000#.....#
#..............#####...E.#
#........................#
#E.............###########
################
