###############
#@.....#....T.#
#......#......#
#...........T.#
#######...#####
000000#...#0000
#######...######
#..............#
#..............#
#..............#
################
