###################
#@.....#....T..::::#######
#......#......#::::#.....#
#...........T.#::::#.....#
#######...#####::::#...E.#
000000#...::::::::::.....#
#######...######:::#.....#
#..............#####...E.#
#....E...................#
#..............###########
################
